####################################################################################################################################################################################
####################################################################################################################################################################################
####################################################################################################################################################################################
###################################################################################.............####################################################################################
###################################################################################.............##########################################.......................###################
###################################################################################.............##########################################.......................###################
###################################################################################.............######.......................#############.......................###################
###################################################################################.............######.......................#############.......................###################
###################################################################################.............######.......................#############.......................###################
###################################################################################.............######.......................#############.......................###################
###################################################################################.............######.......................#############.......................###################
###################################################################################.............######.......................#############.+++...................###################
###################################################################################.............######.......................##############===######################################
###################################################################################.............######.......................##############===######################################
#############........................##############################################.............######.......................##############===######################################
#############........................#########################............#########.............######.......................##############===######################################
#############........................#########################............#########.............######.......................##############===######################################
#############....................S...#########################............#########.............######.......................##############===######################################
#############........................#######...........#######............#########.............######.......................##############===######################################
#############........................#######...........#######............#########.........+++.######.......................##############===######################################
#############........................#######...........#######............##################===#######.......................##############===######################################
#############....................+++.#######...........#######............##################===#######.......................##############===######################################
#################################===########...........#######............##################===#######...................+++.##############===####....................##############
#################################===########...........#######............##################===##########################=========================+...................##############
#################################===########...........#######............##################===##########################=========================+...................##############
#######...........==========================+..........#######............##################===##########################=========================+...................##############
#######...........==========================+..........#######.+++........##################===############################################===####....................##############
#######...........==========================+..........########===##########################===############################################===####....................##############
#######...........===############===########...........########===##########################===############################################===####....................##############
#######...........===############===###########################===##########################===############################################===####....................##############
#######...........===############===###########################===##########################===##############################=====================+...................##############
#######...........===############===###########################===##########################===##############################=====================+...................##############
#######...........===############===###########################===##########################===##############################=====================+...................##############
#######...........===############===###########################===##########################===###############...............+++.##########===####.+++................##############
#######...........===############=============================================================================+..................##########===#####===##############################
#######...........===############=============================================================================+..................##########===#####===##############################
#######...........===############=============================================================================+..................##########===#####===##############################
#######...........===###########.....................##########===############################################...................##########===#####===##############################
#######.......+++.===###########....................+=============############################################...................##########===#####===##############################
##############===#===###########....................+=============######...............#######################...................##########===#####===##.....................#######
##############===#===###########....................+=============######...............#######################...................##########===#####===##.....................#######
##############===#==============+....................###################...............#######################...................##########===#####===##.....................#######
##############===#==============+....................###################...............#######################...................##########===#####===##.....................#######
##############===#==============+....................###################...............#######################...................##########===#####===##.....................#######
##############===#===###########.....................###################...............#######################...................##########===#####===##.....................#######
##############===#===###################################################...............#######################...................##########===#####===##.....................#######
##############===#===###################################################...............#######################...................##########===#####===##.+++.................#######
##############===#===###################################################...............#######################...................##########===#####===###===########################
##############===#===###################################################...............#######################...................##########===#####===###===########################
##############===#===###################################################...............#######################...................##########===#####===###===########################
##############===#===###################################################...............####################################################===#####===###===########################
##############===#===##############################................#####..............+================================####################===#####===###===########################
##############=====================================+...............#####..............+================================####################===#####===###===########################
##############=====================================+...............#####..............+================================####################===#####===###===########################
##############=====================================+...............#####...............############################.+++............########===#####===###===########################
##################===##############################................################################################...............+=========================########################
###...............+++.#############################................################################################...............+=========================########################
###...................#############################................################################################...............+=========================########################
###...................#############################................################################################................#################################################
###...................#############################................################################################................######################.............##############
###...................#############################................################################################................######################.............##############
###..................+==============###############................################################################................######################.............##############
###..................+==============###############................################################################................######################.............##############
###..................+==============###############................################################################................######################.............##############
###...................###########===###############................################################################................######################.............##############
#################################===###############.+++............################################################................######################.............##############
#################################===################===############################################################.+++............######################.............##############
#################################===################===#############################################################===##################################.............##############
#################################===################===#############################################################===##################################.............##############
##################...............===################===#############################################################===##################################.............##############
##################..............+======================#############################################################===##################################.............##############
##################..............+======================#############################################################===###############################===+............##############
##################..............+======================#############################################################===###############################===+............##############
##################...............===################################################################################===###############################===+............##############
##################...............===################################################################################===###############################===.+++.........##############
##################...............===################################################################################===###############################===#===#######################
##################...............===###############################################................#################===###############################===#===#######################
##################...............===###############################################...............+====================###############################===#===#######################
##################...............===###############################################...............+====================###############################===#===#######################
##################...............===###############################################...............+====================###........................####===#===#######################
##################...............===###############################################................#######################.......................+===========#######################
##################...............===###############################################................#######################.......................+===========#######################
##################...........+++.===###############################################................#######################............E..........+===========#######################
#############################===#===###############################################................#######################........................####===###########################
#############################===#===###############################################................#######################........................####===###########################
#############################===#===###############################################................#######################........................####===###########################
#############################===#===###############################################................#######################........................####===###########################
#############################===#===###############################################...............+====================###############################===###########################
#############################===#===###############################################...............+====================###############################===###########################
#############################===#===###############################################...............+====================###############################===###########################
#############################===.+++....................###########################.+++............#################===########################.......+++.##########################
#############################===+......................+===============================#############################===########################...........##########################
#############################===+......................+===============================#############################===########################...........##########################
#############################===+......................+===============================#############################===########################...........##########################
################################........................############################################################===########################...........##########################
################################........................############################################################===########################...........##########################
################################........................############################################################===########################...........##########################
##..................############........................############################################################===########################...........##########################
##..................############........................################....................########################===########################...........##########################
##..................############........................################....................########################===#########===============+..........##########################
##..................############....................+++.################....................########################===#########===============+..........##########################
##..................################################===#################....................########################===#########===============+..........##########################
##..................################################===#################....................########################===#########===############...........##########################
##..................################################===#################....................########################===#########===#################################################
##..................################################===#################....................########################===#########===#################################################
##..................##############################======================+...................########################===#########===#################################################
##..................##############################======================+...................########################===#########===#################################################
##.................+====================##########======================+...................########################===#########===#################################################
##.................+====================##########=====#################................+++.#######################.+++.........+++.################################################
##.................+====================##########=====#################################===========================+................################################################
##..................#################===##########=====#################################===========================+................################################################
#####################################===##########=====#################################===========================+................################################################
#####################################===##########=====############################################################.................################################################
#####################################===##########=====############################################################.................################################################
#####################################===##########=====#####........................###############################.................################################################
#####################################===##########==========+.......................###############################.................################################################
#####################################===##########==========+.......................###############################.................################################################
#####################################===##########==========+.......................###############################.................################################################
####################################.+++..........+++.######........................###############################.................################################################
####################################..................######........................################################################################################################
####################################..................######........................################################################################################################
####################################..................######........................################################################################################################
####################################..................##############################################################################################################################
####################################..................##############################################################################################################################
####################################..................##############################################################################################################################
####################################..................##############################################################################################################################
####################################################################################################################################################################################
####################################################################################################################################################################################
####################################################################################################################################################################################
####################################################################################################################################################################################